wwwwwwhwww
ts.f......
psb..b.p..
.s..fBBf..
.....tt...
......t...
......bf..
.ff...tt..
.f......S.
........b.
....P.Q.b.
...ss.....
..B.......
.......pfp
ssssssssss